3 1 10 1 1 1 1 1 20 20 1 1 0 0 20 20 1 4 0 0
10 0 0 0 10 0 0 10 1 0 0 1 4 1 20 0 1 4 1 1
4 1 0 0 10 0 1 1 1 0 20 1 -100 1 1 0 1 10 0 4
4 10 0 4 4 0 10 1 1 10 20 20 0 10 0 1 1 4 0 4
1 10 0 0 4 1 1 0 0 0 0 4 1 1 1 10 0 4 0 1
10 1 1 1 4 -100 4 4 4 1 1 1 0 0 10 0 0 1 -100 1
0 1 20 0 4 4 0 10 1 1 0 10 10 4 1 1 0 1 0 4
20 20 20 0 0 20 0 1 0 4 0 0 0 0 0 1 4 1 4 10
0 1 20 20 0 20 0 0 0 10 4 0 0 1 1 1 0 4 0 4
1 10 1 0 0 0 0 20 20 1 0 1 10 1 0 20 20 4 1 0
1 10 10 1 1 1 1 1 1 1 1 -100 10 0 0 0 1 10 0 4